10100101101100111100
11110110111111110111
10010100100011100101
00000101000111111101
11111010000101100000
11010011111101100111
10000101011100111011
11111110001100111001
10111111110100111011
10000011101011110011
10100101101110111001
01110110101001110011
01111111010001011110
11110101011011111110
11011010110111101000
11010011001100110100
10011011011111111001
11101000000011110010
00011101100001101110
01111000101011111110
