10101001001111011000
00000110001010100000
01111101100100010000
10021100101001000000
00110010000011001100
00000101100000000000
01000000000000000000
00010110100110010101
00010002000010100010
00000000100110010011
10101011001010001111
00120011001001101000
10000001001000111011
21001000001011001020
01000021000100000101
11010100001100101100
11110101011110100101
01011100201000010000
00101001110000010000
00000110110010201010
